NO ./path_to_the_north_texture
SO ./path_to_the_south_texture


WE ./path_to_the_west_texture


EA ./path_to_the_east_texture
F 80,80,80





C 80,180,250




111111111111111111111
100000000000000000001
100000000000000000001
100000000000000000001
100000000000000000001
100000000000000000001
100000000010000000001
100000000000000000001
100000000000000000001
100000000000000000001
1000000000E0000000001
100000000000000000001
100000000000000000001
100000000000000000001
100000000000000000001
100000000000000000001
100000000000000000001
100000000000000000001
100000000000000000001
100000000000000000001
111111111111111111111
