NO ./path_to_the_north_texture
SO ./path_to_the_south_texture


WE ./path_to_the_west_texture


EA ./path_to_the_east_texture
F 80,80,80





C 80,180,250




111111111111111111
10000000000000000011
100000000000000000001
1000000000000000000011111111111111111111111111
1000000000000000000000000000000000000000000001
1000100100011000000000000000000000000000000001
1000000000000000000000000000000000000000000001
1000000000000000000000000000000000000000000001
1000000000000000000000000000000000000000000001
1000000000000000000000000000000000000000000001
1000000000E00000000000000000000000000000000001
1000000000000000000000000000000000000000000001
1000000000000000000000000000000000000000000001
1000000000000000000000000000000000000000000001
1000000000000000000000000000000000000000000001
1000000000000000000000000000000000000000000001
1000000000000000000000000000000000000000000001
1000000000000000000000000000000000000000000001
1000000000000000000000000000000000000000000001
1111111111111111111111111111111001111111111111
                              1001
                              1001
                              1001
                              1001
                              1001
                              1001
                              1001
                              1001
                              1001
                              1001
                              1001
                              1001
                              1001
                              1001
                              1001
                              1001
                              1001
                              1001
                              1001
                              1001
                              1001
                              1001
                              1001
                              1001
                              1001
                              1001
                              1001
                              1001
                              1001
                              1001
                              1001
                              1001
                              1001
                              1001
                              1001
                              1001
                              1001
                              1001
                              1001
                              1001
                              1001
                              1001
                              1001
                              1001
                              1001
                              1001
                              1001
                              1001
                              1001
                              1001
                              1001
                              1001
                              1001
                              1001
                              1001
                              1001
                              1001
                              1001
                              1001
                              1001
                              1001
                              1001
                              1001
                              1001
                              1001
                              1111
