NO ./path_to_the_north_texture
SO ./path_to_the_south_texture


WE ./path_to_the_west_texture


EA ./path_to_the_east_texture
F 100,0,0





C 80,180,250




111111111111111111111
100000000000000000111
100000000000000000001
100000000000000000001
100000000000000000001
100000100000000000001
100000100000000000001
100000000000000000001
100000100000000000001
1000000000N0000000001
100000100000000000001
100000000000000000001
100000000000000000001
100000000000000000001
100000000000000000001
100000000000000000001
100000000000000000001
100000000000000000001
100000000000000000001
111111111111111111111
