

F      50,134,50

C      123,145,213



SO    ./tex/xpm/south.xpm
WE       ./tex/xpm/west.xpm


EA ./tex/xpm/east.xpm


NO ./tex/xpm/north.xpm

111111111111111111111
100000000000000000111
100000000000000000001
100000000000001000001
10000000000W000000001
100000000000000010011
100000000000000000001
100000000001000000001
100000010001000000001
111011111111111111111
101011000000000000001
101011111111111111111
100000010011000000001
100000011111000000001
100000000000000000001
100000000000000000001
100000001000000000001
100000000000000000001
100000000000000000001
100000000000000000001
100000000000000000001
111111111111111111111
