



NO ./tex/xpm/north.xpm



SO ./tex/xpm/south.xpm


WE ./tex/xpm/west.xpm


EA ./tex/xpm/east.xpm


F 70,70,70
C 137,228,255




111111111111111111111
100000000000000000111
100000000000000000001
100000000000001000001
10000000000E000000001
100000000000000001001
100000000000000000001
100000000001000000001
100000010001000000001
111111111111111111111

111111111111111111111
100000010001000000001
100000011111000000001
100000000000000000001
100000000000000000001
100000001000000000001
100000000000000000001
100000000000000000001
100000000000000000001
100000000000000000001
111111111111111111111
