NO ./path_to_the_north_texture
SO ./path_to_the_south_texture


WE ./path_to_the_west_texture


EA ./path_to_the_east_texture
F 4,220,100,0





C 5,255,0,0


        1111111111111111111111111
        1000000000110000000000001
        1011000001110000000000001
        1001000000000000000000001
        1111111110111111111111111
        1000000000001
      1  100000000000111        
        1111111110111111111111111
        1000000000110000000000001
        10110000011100000100S0001
        1001000000000000000000001
111111111011000001110000000000001
100000000011000001110111111111111
11110110111111011100000010001
11110111111111011101010010001
11000000110101011100000010001
10000000000000001100000010001
100000000000000011010100100011111111111
110000011101010111110111100000000000001
11110111 1110101 1011110100001111111101 
11111111 1111111 11111111111001     101
                            1001    101
                             101    101 
                              101111101 
                               10000001     
                                1111111 