NO ./path_to_the_north_texture
SO ./path_to_the_south_texture


WE ./path_to_the_west_texture


EA ./path_to_the_east_texture
F 80,80,80





C 80,180,250


        1111111111111111111111111                1111111
        1000000000110000000000001                1000001
        101100000111000000000000111111111111111111000001
        100100000000000000000000000000000000000000000001
        111111111011111111111111000000000000000000000001
        1000000000001          1111111111111111111000001
      1  100000000000111                         1000001
        1111111110111111111111111                1000001
        1000000000110000000000001                1000001
        101100000111000001000001                1000011
        1001000000000000000000001                1000001
111111111011000001110000000000001                1000001
100000000011000001110111111111111111111111111111110000011111111111
111101101111110111000000100000000000000000000000000000000000000001
111101111111110111010100100000000000000000000000000000000000000001
11000000110101011100000S100010000000000000000000000000000000000001
100000000000000011000000100010000000000000000000000000000000000001
100000000000000011010100100011111111111111111111111111111111111111
110000011101010111110111100000000000001
11110111 1110101 1011110100001111111101
11111111 1111111 11111111111001     101
                            1001    101
                             101    101
                              101111101
                               10000001
                                1111111