NO ./path_to_the_north_texture
SO ./path_to_the_south_texture


WE ./path_to_the_west_texture


EA ./path_to_the_east_texture
F 80,80,80





C 80,180,250


111111111111111111111111111111111111111111111111111111111111111111
100000000011000001110111111111111111111111111111110000011111111111
111101101111110111000000100000000000010000000100000000000000000001
111101111111110111010100100000000000000000000000000000000000000001
110000001101010111000000100010000000000000000000000000001100000001
100000000000000011000000100010000000010000000000000000001100000001
100000000000000011010100100011111111110011111111111111111111111111
100000000011000001110111111111111111110011111111110000011111111111
111101101111110111000000100000000000010000000100000000000000000001
111101111111110111010100100000000000000000000000000000000000000001
110000001101010111000000100010000000000000000000000000001100000001
100000000000000000000000100010000000010000000000000000001100000001
100000000000000011010100100011111111110011111111111111111111111111
100000000011000001110111111111111111110011111111110000011111111111
111101101111110000000000000000000000000000000100000000000000000001
111101111111110111010100000000000000000000000000000000000000000001
1100000011010101110000000000100000000N0000000000000000001100000001
100000000000000011000000000010000000010000000000000000001100000001
100000000000000000000100000011111111100111111111111111111111111111
100000000011000001110111011111111111100111111111110000011111111111
100000000000000000000000000000000000000000000100000000000000000001
100000000000000000010100000000000000000000000000000000000000000001
100000000000000000000000000010000000000000000000000000001100000001
100000000000000011000000000010000000010000000000000000001100000001
100000000000000011010100000011111111111111111111111111111111111111
100000000011000001110111011111111111111111111111110000011111111111
111101101111110111000000000000000000010000000100000000000000000001
111101111111110111010100000000000000000000000000000000000000000001
110000001101010111000000000010000000000000000000000000001100000001
100000000000000000000000000010000000010000000000000000001100000001
100000100000000000010100000011111111111111111111111111111111111111
100000000011000001110111011111111111111111111111110000011111111111
111101101111110111000000000000000000010000000100000000000000000001
111101111111110111010100000000000000000000000000000000000000000001
110000001101010111000000000010000000000000000000000000001100000001
100000000000000000000000000010000000010000000000000000001100000001
100000000000000011010100000011111111111111111111111111111111111111
111111111111111111111111111111111111111111111111111111111111111111
