NO ./tex/xpm/space1.xpm
SO ./tex/xpm/space2.xpm


WE ./tex/xpm/space3.xpm


EA ./tex/xpm/space4.xpm
F 70,70,70






111111111111111111111
100000000000000000111
100000000000000000001
100000000000000000001
100000000000000000001
100000000000000000001
100000000000000000001
100000000000000000001
100000010001000000001
100000010N01000000001
100000010001000000001
100000011111000000001
100000000000000000001
100000000000000000001
100000001000000000001
100000000000000000001
100000000000000000001
100000000000000000001
100000000000000000001
111111111111111111111

C 137,228,255