NO ./tex/xpm/wall1.xpm
SO ./tex/xpm/wall2.xpm


WE ./tex/xpm/wall3.xpm


EA ./tex/xpm/wall4.xpm
F 64,78,82


C 0,188,114




111111111111111111111
100000000000000000111
100000000000000000001
100000000000000000001
100000000000000000001
100000000000000000001
100000000000000000001
100000000000000000001
100000010001000000001
100000010S000000000111111
100000000111111111111111
100000010001000000001
100000011111000000001
100000000000000000001
100000000000000000001
100000001000000000001
100000000000000000001
100000000000000000001
100000000000000000001
100000000000000000001
111111111111111111111
