
SO         ./tex/xpm/hd2.xpm
NO              ./tex/xpm/hd1.xpm


C            137,28,255

WE            ./tex/xpm/hd3.xpm


EA    ./tex/xpm/hd4.xpm

F     70,70,70


          111
111111111111111111111
100000000000000000111
100000000000000000001
100000000000000000001
100000000000000000001
100000000000000000001
100000000000000000001
100000000000000000001
100000010001000000001
100000010N01000000001
111111111111111111111

111111111111111111111
100000010001000000001
100000011111000000001
100000000000000000001
100000000000000000001
100000001000000000001
100000000000000000001
100000000000000000001
100000000000000000001
100000000000000000001
111111111111111111111
