NO ./tex/xpm/planet1.xpm
SO ./tex/xpm/planet2.xpm


WE ./tex/xpm/planet3.xpm


EA ./tex/xpm/planet4.xpm
F 64,78,82


C 0,188,114




111111111111111111111
100000000000000000111
100000000000000000001
100000000000000000001
100000000000000000001
100000000000000000001
100000000000000000001
100000000000000000001
100000010001000000001
100000010N01000000001
100000010001000000001
100000001110000000001
100000000000000000001
100000000000000000001
100000001000000000001
100000000000000000001
100000000000000000001
100000000000000000001
100000000000000000001
111111111111111111111
