NO ./tex/xpm/space_no.xpm
SO ./tex/xpm/space_so.xpm


WE ./tex/xpm/space_we.xpm


EA ./tex/xpm/space_ea.xpm
F 70,70,70





C 137,228,255


111111111111111111111
100000001000000000101
101011101010101110101
1N1010101010100010001
111010101111101010111
101000101000101010101
101110111110111011101
100000000010000000101
101110111111111010101
101000000010001010001
101011111010101010111
101010000010100010001
101011101110111111111
101010000000100000101
111011111111101110101
100010101000001000101
111010101110111011101
101000100000001000001
101011111011111011101
100000000000001010001
111111111111111111111
